SSS_______
SOSSSS____
SSSSSSSSS_
_SSSSSSSSS
_____SSGSS
______SSS_
################